1 5
           ..........
          ............
          .........o..
 ...o..............o..
...................o.x
.........o...........
.....................
.....................
.....................
.........o...........
.....o...........o...
 ....