1 1
......o.......
........o.....
...o........o.
..............
...o..........
...........ooo
............xo
....o......ooo
.........ooooo
o.............