18 10
oooooooooooooooooooo
o............o.....o
o.o................o
oo...o......o......o
o.................oo
o.........o........o
o..o...............x
o.....o...........oo
o..........o.......o
o........o...o.....o
o..................o
oooooooooooooooooooo