1 6
           ..........
          ............
          .........o..
  ..o..............o..
  .................o.x
.........o...........
.....................
.....................
.....................
.........o...........
.....o............o..
 ....